...............................................
$$$$$$$$$$$$$$$$$$$$$$$$$$$$$$$$$$$$$$$$$$$$$$$
$***********$*********************$***********$
$***********$#####################$***********$
$***********$#####################$***********$
$***********$........$##$.........$***********$
$***********$........$##$.........$***********$
$***********$........$##$.........$***********$
$***********$........$##$.........$***********$
$***********$........$##$.........$***********$
$***********$........$##$.........$***********$
$***********$........$##$.........$***********$
$***********$########$##$#########$***********$
$***********$........$##$.........$***********$
$***********$........$##$.........$***********$
$$$$$$$$$$$$$........$##$.........$$$$$$$$$$$$$
.....................$##$......................
.....................$##$......................
.....................$##$......................
.....................$##$......................
............$$$$$$$$$$##$$$$$$$$...............
$$$$$$$$$$$$####################$$$$$$$$$$$$$$$
************####################***************
***********************************************
...............................................
********###########********#########***********
..........######.............#####.............
............$..................$...............
...............................................
...............................................
........$.............$..............$.........
......#####.........#####..........#####.......
....#########.....#########......#########.....
***********************************************