..................................................
$$$$$$$$$$$$$$$$$$$$$$$$$$$$$$$$$$$$$$$$$$$$$$$$$$
$************$**********************$************$
$************$######################$************$
$************$######################$************$
$************$........$###$.........$************$
$************$........$###$.........$************$
$************$........$###$.........$************$
$************$........$###$.........$************$
$************$........$###$.........$************$
$************$........$###$.........$************$
$************$........$###$.........$************$
$************$########$###$#########$************$
$************$........$###$.........$************$
$************$........$###$.........$************$
$$$$$$$$$$$$$$........$###$.........$$$$$$$$$$$$$$
......................$###$.......................
......................$###$.......................
......................$###$.......................
......................$###$.......................
.............$$$$$$$$$$###$$$$$$$$................
$$$$$$$$$$$$$#####################$$$$$$$$$$$$$$$$
*************#####################****************
**************************************************
..................................................
********###########********#########**************
..........######.............#####................
............$..................$..................
..................................................
..................................................
........$.............$..............$............
......#####.........#####..........#####..........
....#########.....#########......#########........
**************************************************
