...............................................
...............................................
...............................................
$$$$$$$$$$$$$$$$$$$$#.....#$$$$$$$$$$$$$$$$$$$$
********************#.....#********************
********************#.....#********************
********************#.....#********************
********************#.....#********************
********************#.....#********************
*****$$$$$$$$$$*****#.....#*****$$$$$$$$$$*****
*****$$$$$$$$$$*****#.....#*****$$$$$$$$$$*****
*****$$$$$$$$$$*****#.....#*****$$$$$$$$$$*****
*****$$$$$$$$$$*****#.....#*****$$$$$$$$$$*****
*****$$$$$$$$$$*****#.....#*****$$$$$$$$$$*****
*****$$$$$$$$$$*****#.....#*****$$$$$$$$$$*****
*****$$$$$$$$$$*****#.....#*****$$$$$$$$$$*****
*****$$$$$$$$$$*****#.....#*****$$$$$$$$$$*****
********************#.....#********************
********************#.....#********************
********************#.....#********************
********************#.....#********************
********************#.....#********************
#####################.....#####################
...............................................
...............................................
...............................................
...............................................